#################################################################################
# ## ## ## ## ## ## ## ## ## ## ## ## ## ## ## ## ## ## ## ## ## ## ## ## ## ## #
#################################################################################
###   ######   ######   ######   ######   ######   ######   ######   ######   ###
# #   # ## #   # ## #   # ## #   # ## #   # ## #   # ## #   # ## #   # ## #   # #
###   ######   ######   ######   ######   ######   ######   ######   ######   ###
#################################################################################
# ## ## ## ## ## ## ## ## ## ## ## ## ## ## ## ## ## ## ## ## ## ## ## ## ## ## #
#################################################################################
#########         ##################         ##################         #########
# ## ## #         # ## ## ## ## ## #         # ## ## ## ## ## #         # ## ## #
#########         ##################         ##################         #########
###   ###         ###   ######   ###         ###   ######   ###         ###   ###
# #   # #         # #   # ## #   # #         # #   # ## #   # #         # #   # #
###   ###         ###   ######   ###         ###   ######   ###         ###   ###
#########         ##################         ##################         #########
# ## ## #         # ## ## ## ## ## #         # ## ## ## ## ## #         # ## ## #
#########         ##################         ##################         #########
#################################################################################
# ## ## ## ## ## ## ## ## ## ## ## ## ## ## ## ## ## ## ## ## ## ## ## ## ## ## #
#################################################################################
###   ######   ######   ######   ######   ######   ######   ######   ######   ###
# #   # ## #   # ## #   # ## #   # ## #   # ## #   # ## #   # ## #   # ## #   # #
###   ######   ######   ######   ######   ######   ######   ######   ######   ###
#################################################################################
# ## ## ## ## ## ## ## ## ## ## ## ## ## ## ## ## ## ## ## ## ## ## ## ## ## ## #
#################################################################################
###########################                           ###########################
# ## ## ## ## ## ## ## ## #                           # ## ## ## ## ## ## ## ## #
###########################                           ###########################
###   ######   ######   ###                           ###   ######   ######   ###
# #   # ## #   # ## #   # #                           # #   # ## #   # ## #   # #
###   ######   ######   ###                           ###   ######   ######   ###
###########################                           ###########################
# ## ## ## ## ## ## ## ## #                           # ## ## ## ## ## ## ## ## #
###########################                           ###########################
#########         #########                           #########         #########
# ## ## #         # ## ## #                           # ## ## #         # ## ## #
#########         #########                           #########         #########
###   ###         ###   ###                           ###   ###         ###   ###
# #   # #         # #   # #                           # #   # #         # #   # #
###   ###         ###   ###                           ###   ###         ###   ###
#########         #########                           #########         #########
# ## ## #         # ## ## #                           # ## ## #         # ## ## #
#########         #########                           #########         #########
###########################                           ###########################
# ## ## ## ## ## ## ## ## #                           # ## ## ## ## ## ## ## ## #
###########################                           ###########################
###   ######   ######   ###                           ###   ######   ######   ###
# #   # ## #   # ## #   # #                           # #   # ## #   # ## #   # #
###   ######   ######   ###                           ###   ######   ######   ###
###########################                           ###########################
# ## ## ## ## ## ## ## ## #                           # ## ## ## ## ## ## ## ## #
###########################                           ###########################
#################################################################################
# ## ## ## ## ## ## ## ## ## ## ## ## ## ## ## ## ## ## ## ## ## ## ## ## ## ## #
#################################################################################
###   ######   ######   ######   ######   ######   ######   ######   ######   ###
# #   # ## #   # ## #   # ## #   # ## #   # ## #   # ## #   # ## #   # ## #   # #
###   ######   ######   ######   ######   ######   ######   ######   ######   ###
#################################################################################
# ## ## ## ## ## ## ## ## ## ## ## ## ## ## ## ## ## ## ## ## ## ## ## ## ## ## #
#################################################################################
#########         ##################         ##################         #########
# ## ## #         # ## ## ## ## ## #         # ## ## ## ## ## #         # ## ## #
#########         ##################         ##################         #########
###   ###         ###   ######   ###         ###   ######   ###         ###   ###
# #   # #         # #   # ## #   # #         # #   # ## #   # #         # #   # #
###   ###         ###   ######   ###         ###   ######   ###         ###   ###
#########         ##################         ##################         #########
# ## ## #         # ## ## ## ## ## #         # ## ## ## ## ## #         # ## ## #
#########         ##################         ##################         #########
#################################################################################
# ## ## ## ## ## ## ## ## ## ## ## ## ## ## ## ## ## ## ## ## ## ## ## ## ## ## #
#################################################################################
###   ######   ######   ######   ######   ######   ######   ######   ######   ###
# #   # ## #   # ## #   # ## #   # ## #   # ## #   # ## #   # ## #   # ## #   # #
###   ######   ######   ######   ######   ######   ######   ######   ######   ###
#################################################################################
# ## ## ## ## ## ## ## ## ## ## ## ## ## ## ## ## ## ## ## ## ## ## ## ## ## ## #
#################################################################################
